{
    "23": 2,
    "28": 2,
    "24": 2,
    "29": 2,
    "7": 0,
    "18": 0,
    "8": 0,
    "19": 4,
    "21": 4,
    "22": 4,
    "20": 4,
    "10": 3,
    "11": 3,
    "12": 3,
    "14": 5,
    "13": 5,
    "26": 5,
    "17": 6,
    "15": 6,
    "16": 6,
    "6": 0,
    "2": 1,
    "3": 1,
    "4": 1,
    "5": 0,
    "25": 5,
    "9": 1,
    "30": 5,
    "27": 5,
    "1": 1,
    "31": 6
}